
Helllo
sadfas

dsf
asf
sadf
asssssss

2 2 2aaadss 2ccxsd 2 2 2 2 2 2
2 0 0 0 0 0 0dsf 0 0 2
2 0 0 0 0 3, 0, fsd0, 0, 2
2, 0, 0, 2, 1, 0, 2, 0, 0, 2
2, sdf2, 4, 4,s dsfs0, 0, 2, 0, 0, 2
2, 0, 0, 2, 2f, 0, 0, 2, 0, 2
2, 0, 2, 2, s0, 0, 0, 0, 0, 2
2, 0, 3, 0sf, 0, 0, 0, 0, 0, 2
2, 0, 0, 0, 0, 0, 0, 0, 0, 2
2, 2, 2,ds 2, 2, 2, 2, 2, 2, 2

sfdsfsdf



